R 780 600
NO ./ressources/imgs/north.xpm
SO ./ressources/imgs/north.xpm
WE ./ressources/imgs/north.xpm
EA ./ressources/imgs/north.xpm
S ./ressources/imgs/barrel.xpm
C 62,198,247
F 114,114,114
111111111111111111111111111111111111111111111111111111111111111111111111111111111111111111111111111111111111111111111111111111111111111111111111
100100000000000000000011111111111111111111111111111111111100000000000000000000000000000000000000000000000000000000000000000000001111111
102000000000000000000000000000000000000000000000000000000000000000000000000000000000000000000000000000000000000000000000000000000000001111111
110000000000000000000000000011111111111111111111111111111111111100000000000000000000000000000000000000000000000000000000000000000000001111111
100000111111111111111111111111111111111111000000000000000000000000000000000000000000000000111111111111111111111111111111111111111111111111111
1000000000000000000000000000000000000000000000000000000011111110000000000000000000000001111111111111111
10000000000000000000000000000W00111111111111111111111111111111111111000000000000001111111111111111111111111111111111111111
1000000000000000000111111111111111111111111111111111111000000000000000000000000000000000000000000000000000000000011111111
1000000000000000001111111111111111111111111111111111110000000000000000000000000000000000000000000000000001111111111111111
1111111111000000000000000000000000000000000011111111111111111111111111111111111111111111111111111111111111111
11110000000000000000000000000000000000111111111111111111111111111111111
1100000000000000000000000000000000000000000000000000000000011111111
110000000000000000000000000000000000111111111111111111111111111111111
11111000000000000000000000000000000000000000000000000000000000011111111
1111000000000000000000000000000000000000000000000000000000000011111111
111110000000000000000000000000000000000111111111111111111111111111111111111111111111
1100000000000000000000000000000111111111111111111111111100000000000000000000000011111111111111
10000000000000000000000000000000111111111111111111111111111111111111111111111111111111
1000000000000000000111111110000000000000000000000001111111111111111111111111111111111
111111111111111111111111111111111111111111111111111111111111111111111111111111111111111111111111111111111111