R 600 600
NO ./ressources/imgs/north.xpm
SO ./ressources/imgs/south.xpm
WE ./ressources/imgs/west.xpm
EA ./ressources/imgs/east.xpm
S ./ressources/imgs/barrel.xpm
C 200,200,200
F 114,114,114
1111111
10010011111111111111111111111111
1020000000000000000000000000001111
11000011111111111111111111111111
10N0011
1000001
1000001
1000011
1000011
1111111
