R 800 580
NO ./ressources/imgs/north.xpm
SO ./ressources/imgs/south.xpm
WE ./ressources/imgs/west.xpm
EA ./ressources/imgs/east.xpm
S ./ressources/imgs/barrel.xpm
C 62,198,250
F 100,100,100
111111
10010011111111111111111111111111111
1020E00000000000000000000000002000111
110001111111111111111111111111111111
1000011
1000001
1000001
1000011
1111111