R 800 600
NO ./ressources/imgs/north.xpm
SO ./ressources/imgs/south.xpm
WE ./ressources/imgs/west.xpm
EA ./ressources/imgs/east.xpm
S ./ressources/imgs/barrel.xpm
F 62,198,247
C 114,114,114
111111
100101
10N001
111111
