R 600 600
NO ./ressources/imgs/north.xpm
SO ./ressources/imgs/south.xpm
WE ./ressources/imgs/west.xpm
EA ./ressources/imgs/east.xpm
S ./ressources/imgs/barrel.xpm
F 62,198,247
C 214,145,114
11111
100101
102001
1100N1
100000111111111
100000000000001
100000000000001
100001111111111
1000011
1111111