NO ./ressources/imgs/north.xpm
SO ./ressources/imgs/south.xpm
WE ./ressources/imgs/west.xpm
EA ./ressources/imgs/east.xpm
S ./ressources/imgs/barrel.xpm
F 0,153,15
C 255,255,255
R 640 480

1111111111111111111111111
1000000000000000000000001
1100000000000000000000001
100000000000000000000000111111111
111111111000000000000000000000001
10000000000000000000000000001111
10000000000000E10000020000001
10000000000000000000000000001
10000000000000000000000000001
10000000000000000000000000001
10000000000000000001010000001
11000001110101011111011110101
11110111111101211101111010001
11111111111111111111111111111